1111111111111111111
10000001C0000001001
1000000010000000011
10C0000000000111001
100P10010001E110001
1111111111111111111