1111111111111111111
100000CCC0000001C01
10000CC010000000001
100000C010000111001
1C0P1001C10001E0001
1111111111111111111