1111111111111111111
10000001C0000001001
10C0000010000000011
10C0000000000001001
100P10010000E1100C1
1111111111111111111