1111111111111111111
10000001C0000001001
10C0000000000000011
100P10010000E1100C1
1111111111111111111