1111111111111111111
100000C1C0000001C01
10000CC010000000001
100000C000000111001
1C0P1001C000E110001
1111111111111111111