111111
1P00E1
100101
1C0001
111111
